1111111111111
10010000000C1
10z0011111001
1P0011E000011
1111111111111