1111111111111
1001C000C00C1
1000011111001
1P0011E000C11
1111111111111